xxxxxxxxxxxxxxxxxxxx
x....x........x....x
x.xx.x.xxxxxx.x.xxox
x.x..............x.x
x.x.xx.xx  xx.xx.x.x
x......x0123x......x
x.x.xx.xxxxxx.xx.x.x
x.x..............x.x
xoxx.x.xxxxxx.x.xx.x
x....x...P....x....x
xxxxxxxxxxxxxxxxxxxx