xxxxxxxxxxxxxxxxxxxx
x                  x
x                  x
x                  x
x                  x
x       .          x
x                  x
x        P   r     x
xxxxxxxxxxxxxxxxxxxx
