xxxxxxxxxxxxxxxxxxxx
x                  x
x                  x
x                o x
xp                 x
x       fS          x
x                 x
x b           r    x
xxxxxxxxxxxxxxxxxxxx
xxxxxxxxPxxxxxxxxxxx
xxxxxxxxxxxxxxxxxxxx
