xxxxxxxxxxxxxxxxxxxx
x                  x
x             b    x
x                  x
x    x             x
x       fS         x
x    x     xxxx    x
x    x     xr      x
xxxxxxxx xxxxxxxxxxx
xxxxxxxxPxxxxxxxxxxx
xxxxxxxxxxxxxxxxxxxx
