###################
###################
xxxxxxxxxxxxxxxxxxx
x........x........x
xfxx.xxx.x.xxx.xxfx
x.................x
x.xx.x.xxxxx.x.xx.x
x....x...x...x....x
xxxx.xxx.x.xxx.xxxx
###x.x.......x.x###
xxxx.x.xxrxx.x.xxxx
.......xbpox.......
xxxx.x.xxxxx.x.xxxx
###x.x.......x.x###
xxxx.x.xxxxx.x.xxxx
x........x........x
x.xx.xxx.x.xxx.xx.x
x..x.....P.....x..x
xx.x.x.xxxxx.x.x.xx
x....x...x...x....x
xfxxxxxx.x.xxxxxxfx
x.................x
xxxxxxxxxxxxxxxxxxx