#########x#########
###################
xxxxxxxxxxxxxxxxxxx
x........x........x
xfxx.xxx.x.xxx.xxfx
x.................x
x.xx.x.xxxxx.x.xx.x
x....x.......x....x
xxx.xxx.xxx.xxx.xxx
##x.x...pSp...x.x##
xxx.x.xxxdxxx.x.xxx
rrrrrrxpppppxbbbbbb
xxx.x.xxxxxxx.x.xxx
##x.x.ooooooo.x.x##
xxx.x.xxxxxxx.x.xxx
x........x........x
x.xx.xxx.x.xxx.xx.x
x..x...........x..x
xx.x.x.xxxxx.x.x.xx
x....x...x...x....x
xfxxxxxx.x.xxxxxxfx
x........P........x
xxxxxxxxxxxxxxxxxxx